NO ./textures/no_tex.png
SO ./textures/so_tex.png
WE ./textures/we_tex.png
EA ./textures/ea_tex.png

F 150,75,20	
C 130,200,22

1111111111111111111111
10111111001000000101
10111100100000010001
10111111100000000001
10000000000000000001   
10000000000000010001   
10000011111111110001
100000010E000D000001
10000001111111100001
10111111111111111101
11111111111111111111