NO ./textures/no_tex.png
SO ./textures/so_tex.png
WE ./textures/we_tex.png
EA ./textures/ea_tex.png

C 5,150,222
F 150,75,20

11111111111111111111
10011100100000000001
1001 100100000010001
10001000100000000001
10000000000000000001
10000000000000010001
10000011111111100001
100000011E0000000001
10000001111111100001
10111111111111111101
11111111111111111111