NO ./textures/no_tex.png
SO ./textures/so_tex.png
WE ./textures/we_tex.png
EA ./textures/ea_tex.png

F 150,5,2,
C 130,200,229,

11111111111111111111
10000000100000000001
10000000100000010001
10000000100000000001
10000000000000000001
10000000000000010001
10000011111111100001
100000011E1000000001
10000001111111100001
10111111111111111101
11111111111111111111