NO ./textures/we_text.png
SO ./textures/we_text.png
WE ./textures/we_text.png
EA ./textures/we_text.png

F 150,75,20
C 130,200,229

11111111111111111111
10000000100000000001
10000000100000010001
10000000100000000001
10000000000000000001
10000000000000010001
10000011111111100001
100000010E0000000001
10000001111111100001
10111111111111111101
11111111111111111111