11111111       11111111111
110000011      1000000000011
1000000001    110000000000001111
100000111      110000000000000001
1001111        100000000000000011
101           1000000010000000001
101         1100001 100000001111
101111111111000001000000001111
10000000000000000000000001
10111111111100000000000111
101         111100000000001
101            100000000011
100111         1100000000001
1000001        1000000N0001
10000001       1000000000001
110000011      100000000111
11111111       1111111111
