NO ./textures/ea_text.png
SO ./textures/we_text.png
WE ./textures/we_text.png
EA ./textures/ea_text.png

F 150,75,0
C 130,200,229

11111111       11111111111
111110011      1000000000011
100000001    110000000000001111
100000111      11000000000000001
1001111       1100000000000000011
101          1000010010000000001
101        1100001 1000000011111
101111111111000001110000001111
10000000000000000000000001
10111111111100000000000111
101         111100000000001
101            100000000011
100111         1100000000001
1000001        1000000N0001
10000001       1000000000001
110000011      100000000111
11111111       1111111111
