111111111111
100000000001
10000000001
1000000001
100000001
10000001
100W001
10000011
100000001
1000000001
10000000001
100000000001
111111111111