NO ./textures/no_text.png
SO ./textures/we_text.png
WE ./textures/we_text.png
EA ./textures/we_text.png

F 150,75,0
C 130,200,229

1
1
1
1
1
1
1
1
111110111111
1000000N0001
111111111111
