1111111111
1000000001
100001111
10011
101
1N1
101
10011
100001111
1000000001
1111111111