NO ./textures/we_text.png
SO ./textures/we_text.png
WE ./textures/we_text.png
EA ./textures/we_text.png

F 150,75,0
C 130,200,229

1111111111
10E0000001
100001111
10011
101
1D1
101
10011
1000011111
1000000001
1111111111