NO ./textures/no_text.png
SO ./textures/we_text.png
WE ./textures/we_text.png
EA ./textures/we_text.png

F 255,0,0
C 0,0,0

11111111111111111111
10000000100000000001
10000000100000W10001
10000000100000000001
10000000000000000001
10000000000000010001
10000000100000000001
10000000000000000001
10000000000000000001
10111111111111111101
11111111111111111111