NO ./path_to_the_north_texture
SO ./path_to_the_south_texture
WE ./path_to_the_west_texture
EA ./path_to_the_east_texture

F 150,75,0
C 130,200,229

1111111111111111111111
1000000000000000000001
1011110111111111011101
1000010000001001000101
1000010000001001000101
1000010111111001111101
1000010100000000000001
1000010101111111111101
1000000001E00000000001
1111111111111111111101
1000000000000000000001
1011111111110111111101
1000000000010000000001
1000111110010111110001
1000000000000000000001
1111111111111111111111
