11111111111111111111
10000000000000000001
1011111100N001111101
10000001000001000001
10001111001111000101
10001000010000000101
10111011110111110101
10000000000000000001
10111111111111111101
11111111111111111111